1111111111111
1X000C0000C01
10C0011111001
100011E00P001
1111111111111